50 50 26 47 25 1
1 1 1 1 1 1 1 1 1 1 1 1 1 1 1 1 1 1 1 1 1 1 1 1 1 1 1 1 1 1 1 1 1 1 1 1 1 1 1 1 1 1 1 1 1 1 1 1 1 1
1 3 3 3 3 3 3 3 0 0 0 0 0 0 0 0 0 0 0 0 0 0 0 0 0 0 0 0 0 0 0 0 0 0 0 4 0 0 0 0 0 0 0 0 0 0 0 0 0 1
1 3 3 3 3 3 3 3 0 0 0 0 0 0 0 0 0 0 0 0 0 0 0 0 0 0 0 0 0 0 0 0 0 0 4 4 0 0 0 0 0 0 0 0 0 0 0 0 0 1
1 3 3 3 3 3 3 3 0 0 0 0 0 0 0 0 0 0 0 0 0 0 0 0 3 3 3 3 3 0 0 0 0 0 4 0 0 0 0 0 0 0 0 0 0 0 0 0 0 1
1 3 3 3 3 3 3 0 0 0 0 0 0 0 0 0 0 0 0 0 0 0 3 3 3 3 3 3 3 0 0 0 0 0 4 0 0 0 0 0 0 0 0 0 0 0 0 0 0 1
1 3 3 3 3 3 3 0 0 0 0 0 0 0 0 0 0 0 0 0 0 3 3 3 3 3 3 3 3 0 0 0 0 4 4 0 0 0 0 0 0 0 0 0 0 0 0 0 0 1
1 3 3 3 3 3 3 0 0 0 0 0 3 3 3 0 0 0 0 0 0 3 3 3 3 3 3 3 3 0 0 0 4 4 0 0 0 0 0 0 0 0 0 0 0 0 0 0 0 1
1 3 3 3 3 3 0 0 0 0 0 3 3 3 3 3 3 0 0 0 0 0 3 3 3 3 3 3 0 0 0 0 4 0 0 0 0 0 0 0 0 0 0 0 0 0 0 0 0 1
1 3 3 3 0 0 0 0 0 0 3 3 3 3 3 3 3 0 0 0 0 0 0 0 3 3 3 0 0 0 0 4 4 0 0 0 0 0 0 0 0 0 0 0 0 0 0 0 0 1
1 3 3 3 0 0 0 0 0 0 3 3 3 3 3 3 3 0 0 0 0 0 0 0 0 0 0 0 0 0 4 4 0 0 0 0 0 3 3 3 3 3 3 0 0 0 0 0 0 1
1 0 0 0 0 0 0 0 0 0 3 3 3 3 3 3 3 0 0 0 0 0 0 0 0 0 0 0 0 4 4 0 0 0 3 3 3 3 3 3 3 3 3 3 0 0 0 0 0 1
1 0 0 0 0 0 0 0 0 0 0 3 3 3 3 3 0 0 0 0 0 0 0 0 0 0 0 0 4 4 0 0 0 0 3 3 3 3 3 3 3 3 3 3 0 0 0 0 0 1
1 4 4 4 4 4 4 4 4 0 0 0 3 3 0 0 0 0 0 0 0 0 0 0 0 0 0 4 4 0 0 0 0 0 0 3 3 3 3 3 3 3 3 3 0 0 0 0 0 1
1 0 0 0 0 0 0 0 4 4 0 0 0 0 0 0 0 0 3 3 3 3 3 0 0 0 4 4 0 0 0 0 0 0 0 3 3 3 3 3 3 3 3 3 0 0 0 0 0 1
1 0 0 0 0 0 0 0 0 4 4 4 0 0 0 0 0 3 3 3 3 3 3 3 0 0 4 0 0 0 0 0 0 0 0 0 0 0 0 0 0 0 0 0 0 0 0 0 0 1
1 0 0 0 3 3 3 3 0 0 0 4 4 0 0 0 3 3 3 3 3 3 3 3 0 0 4 0 0 0 0 0 0 0 0 0 0 0 0 0 0 0 0 0 0 0 0 0 0 1
1 0 0 3 3 3 3 3 3 0 0 0 4 0 0 0 3 3 3 3 3 3 3 3 0 0 4 0 0 0 0 0 0 0 0 0 0 0 0 0 0 0 0 0 0 0 0 0 0 1
1 0 0 3 3 3 3 3 3 0 0 0 4 4 0 0 0 3 3 3 3 3 3 0 0 0 4 0 0 0 0 0 0 0 0 0 0 0 0 0 0 0 0 0 0 0 0 0 0 1
1 0 0 3 3 3 3 3 3 0 0 0 0 4 4 0 0 3 3 3 3 3 0 0 0 0 4 0 0 3 3 3 3 3 3 0 0 0 0 0 0 0 0 0 0 0 0 0 0 1
1 0 0 3 3 3 3 3 3 0 0 0 0 0 4 4 0 0 0 0 0 0 0 0 0 0 4 0 3 3 3 3 3 3 3 3 0 0 0 0 0 0 0 0 0 4 4 4 5 1
1 0 0 3 3 3 3 0 0 0 0 0 0 0 0 4 4 4 0 0 0 0 0 0 0 0 4 0 3 3 3 3 3 3 3 3 3 0 0 0 0 0 0 4 4 4 0 0 0 1
1 0 0 3 3 3 3 0 0 0 0 0 0 0 0 0 0 4 4 4 0 0 0 0 0 0 4 0 3 3 3 3 3 3 3 3 3 0 0 0 0 4 4 4 0 0 0 0 0 1
1 0 0 0 0 3 0 0 0 0 0 0 0 0 0 0 0 0 0 4 4 0 0 0 0 0 4 0 0 3 3 3 3 3 3 3 3 0 0 0 4 4 0 0 0 0 0 0 0 1
1 0 0 0 0 0 0 0 0 0 0 3 3 3 3 3 3 3 0 0 4 0 0 0 0 0 4 0 0 0 0 3 3 3 3 3 0 0 0 4 4 0 0 0 3 3 0 0 0 1
1 0 0 0 0 0 0 0 0 0 3 3 3 3 3 3 3 3 0 0 4 0 0 0 0 0 4 0 0 0 0 0 0 0 0 0 4 4 4 4 0 0 0 3 3 3 3 0 0 1
1 0 0 0 0 0 0 0 3 3 3 3 3 3 3 3 3 3 0 0 4 0 0 0 0 0 4 0 0 0 0 0 0 0 4 4 4 0 0 0 0 0 3 3 3 3 3 0 0 1
1 0 0 0 0 0 0 0 3 3 3 3 3 3 3 3 3 3 0 0 4 4 4 4 4 4 4 4 4 4 4 4 4 4 4 0 0 0 0 0 3 3 3 3 3 3 3 0 0 1
1 0 0 0 0 0 0 0 0 3 3 3 3 3 3 3 3 0 0 0 4 0 0 0 0 0 0 0 0 0 0 0 0 0 0 0 3 3 3 3 3 3 3 3 3 3 3 0 0 1
1 0 0 0 0 0 0 0 0 0 3 3 3 3 3 3 0 0 0 0 4 0 0 0 0 0 0 0 0 0 0 0 0 0 3 3 3 3 3 3 3 3 3 3 3 3 3 0 0 1
1 0 0 0 0 0 0 0 0 0 0 0 0 0 0 0 0 0 0 0 4 0 0 0 0 3 3 3 3 0 0 0 0 0 3 3 3 3 3 3 3 3 3 3 3 3 0 0 0 1
1 0 0 0 4 4 4 4 4 4 4 4 0 0 0 0 0 0 0 0 4 0 0 3 3 3 3 3 3 3 0 0 0 0 3 3 3 3 3 3 0 0 0 0 0 0 0 0 0 1
1 4 4 4 4 0 0 0 0 0 0 4 4 4 4 4 4 4 4 4 4 0 0 3 3 3 3 3 3 3 0 0 0 0 3 3 3 0 0 0 0 0 0 0 0 0 0 3 3 1
1 0 0 0 0 0 0 0 0 0 0 0 0 0 0 0 0 0 0 0 4 0 0 0 3 3 3 3 3 3 0 0 0 0 0 0 0 0 0 0 0 0 0 0 3 3 3 3 3 1
1 0 0 0 0 3 3 3 0 0 0 0 0 0 0 0 0 0 0 0 4 0 0 0 0 0 0 0 0 0 0 0 0 0 0 0 0 0 0 0 0 0 3 3 3 3 3 3 3 1
1 0 0 0 3 3 3 3 3 3 3 3 0 0 0 0 0 0 0 0 4 4 0 0 0 0 0 0 0 0 0 0 0 0 0 0 0 0 0 0 0 0 0 3 3 3 3 3 3 1
1 0 0 0 3 3 3 3 3 3 3 3 0 0 0 0 0 0 0 0 0 4 4 4 4 4 0 0 0 0 0 0 0 0 0 0 0 0 0 0 0 0 0 0 3 3 3 3 3 1
1 0 0 0 3 3 3 3 3 3 3 3 0 0 0 0 0 0 0 0 0 0 0 0 0 4 4 0 0 0 0 0 0 0 0 4 4 4 4 4 4 4 0 0 0 0 3 3 3 1
1 0 0 0 3 3 3 3 3 3 3 3 0 0 0 0 0 0 0 0 3 3 3 0 0 0 4 0 0 0 0 0 4 4 4 4 2 2 2 2 2 4 4 0 0 0 3 3 3 1
1 0 0 0 3 3 3 3 3 3 3 0 0 0 0 0 0 0 3 3 3 3 3 0 0 0 4 0 0 0 4 4 4 2 2 2 2 2 2 2 2 2 4 4 4 0 0 3 3 1
1 0 0 0 3 3 3 3 3 3 0 0 0 0 0 0 0 0 3 3 3 3 3 0 0 0 4 0 0 0 4 2 2 2 2 2 2 2 2 2 2 2 2 2 4 0 0 3 3 1
1 0 0 0 0 3 3 3 0 0 0 0 0 0 0 0 0 0 3 3 3 3 3 0 0 0 4 0 0 0 4 2 2 2 2 2 2 2 2 2 2 2 2 2 4 0 0 3 3 1
1 0 0 0 0 0 0 0 0 0 0 0 0 0 0 0 0 0 3 3 3 3 3 0 0 0 4 0 0 0 4 2 2 2 2 2 2 2 2 2 2 2 2 2 4 0 0 3 3 1
1 0 0 0 0 0 0 0 0 0 0 0 0 0 0 0 0 0 0 0 0 0 0 0 0 0 4 0 0 0 4 2 2 2 2 2 2 2 2 2 2 2 2 2 4 0 0 3 3 1
1 0 0 0 0 0 0 0 0 0 0 3 3 3 3 3 0 0 0 0 0 0 0 0 0 0 4 0 0 0 4 2 2 2 2 2 2 2 2 2 2 2 2 4 4 0 0 3 3 1
1 0 0 0 0 0 0 0 0 3 3 3 3 3 3 3 0 0 0 0 0 0 0 0 0 0 4 0 0 0 4 2 2 2 2 2 2 2 2 2 2 2 2 4 0 0 3 3 3 1
1 0 0 0 0 0 0 0 0 3 3 3 3 3 3 3 0 0 0 0 0 0 0 0 0 0 4 0 0 0 4 4 2 2 2 2 2 2 2 2 2 4 4 4 0 0 3 3 3 1
1 0 0 0 0 0 0 0 0 3 3 3 3 3 3 3 0 0 0 0 0 0 0 0 0 0 4 0 0 0 0 4 4 4 4 4 4 4 4 4 4 4 0 0 0 3 3 3 3 1
1 0 0 0 0 0 0 0 0 0 3 3 3 3 3 0 0 0 0 0 0 0 0 0 0 0 4 0 0 0 0 0 0 0 0 0 0 0 0 0 0 0 0 0 3 3 3 3 3 1
1 0 0 0 0 0 0 0 0 0 0 0 0 0 0 0 0 0 0 0 0 0 0 0 0 0 5 0 0 0 0 0 0 0 0 3 3 3 3 3 3 3 3 3 3 3 3 3 3 1
1 1 1 1 1 1 1 1 1 1 1 1 1 1 1 1 1 1 1 1 1 1 1 1 1 1 1 1 1 1 1 1 1 1 1 1 1 1 1 1 1 1 1 1 1 1 1 1 1 1